border_size=1
usage=map

Rd          , Rd          , Gs^Fp       , Gs^Fp       , Gs^Fp       , Gs^Fmf      , Gs^Fmf      , Gs^Fp       , Gs^Fmf      , Gs^Fmf      , Gs^Fmf      , Gs^Fmf      , Gs^Fmf      , Gs^Fdf      , Gs^Fdf      , Gs^Fp       , Gs^Fp       , Gs^Fp       , Gs^Fmf      , Gs^Fp       , Gs^Fp       , Gs^Fp       , Gs^Fp       , Gs^Fp       , Gs^Fp       , Gs^Fp       , Gs^Fp       , Gs^Fp       , Hh^Fmf      , Hh^Fdf      , Hh^Fdf      , Hh^Fdf      , Hh^Fdf      , Hh^Fdf      , Hh^Fdf      , Gs^Fp       , Gs^Fp       , Gs^Fp       , Gs^Fp       , Gs^Fp       , Gs^Fp       , Gs^Fp       
Gs^Fp       , Rd          , Rd          , Gs^Fp       , Gs^Fp       , Gs^Fp       , Gs^Fp       , Gs^Fmf      , Gs^Fmf      , Gs^Fmf      , Gs^Fmf      , Gs^Fmf      , Gs^Fdf      , Gs^Fmf      , Gs^Fdf      , Gs^Fdf      , Gg^Fet      , Gs^Fp       , Gs^Fp       , Gs^Fmf      , Gs^Fmf      , Gs^Fdf      , Gs^Fdf      , Gs^Fp       , Gs^Fp       , Gs^Fp       , Gs^Fp       , Gs^Fp       , Gs^Fp       , Hh^Fmf      , Hh^Fmf      , Hh^Fdf      , Hh^Fdf      , Hh^Fmf      , Hh^Fmf      , Hh^Fdf      , Gs^Fp       , Gs^Fp       , Gs^Fp       , Gs^Fp       , Gs^Fp       , Gs^Fp       
Gs^Fp       , Rd          , Rd          , Gs^Fp       , Gs^Fp       , Gg^Fet      , Gs^Fp       , Gs^Fmf      , Gs^Fmf      , Gs^Fmf      , Gs^Fmf      , Gs^Fdf      , Gs^Fdf      , Gs^Fdf      , Gs^Fmf      , Gs^Fdf      , Gs^Fdf      , Gs^Fp       , Gs^Fmf      , Gs^Fmf      , Gs^Fmf      , Gs^Fdf      , Gs^Fdf      , Gs^Fdf      , Gs^Fp       , Gs^Fp       , Gs^Fp       , Gs^Fp       , Gs^Fp       , Gs^Fp       , Gs^Fp       , Hh^Fmf      , Hh^Fmf      , Hh^Fdf      , Gs^Fp       , Gs^Fp       , Gs^Fp       , Gs^Fmf      , Gs^Fmf      , Gs^Fdf      , Gs^Fdf      , Gs^Fp       
Gs^Fp       , Gs^Fdf      , Gs^Fdf      , Rd          , Rd          , Gs^Fp       , Gs^Fp       , Gs^Fdf      , Gs^Fmf      , Gs^Fmf      , Gs^Fp       , Gs^Fmf      , Gs^Fmf      , Gs^Fdf      , Gs^Fdf      , Gs^Fmf      , Gs^Fmf      , Gs^Fp       , Gg          , Gs^Fmf      , Gs^Fmf      , Gs^Fmf      , Gg          , Gs^Fdf      , Gs^Fp       , Gs^Fp       , Gs^Fp       , Gs^Fp       , Gs^Fp       , Gs^Fp       , Gs^Fp       , Gs^Fp       , Gs^Fp       , Hh^Fmf      , Gs^Fp       , Gs^Fp       , Gs^Fp       , Gs^Fp       , Gs^Fp       , Gs^Fmf      , Gs^Fp       , Gs^Fdf      
Gs^Fp       , Gs^Fp       , Gs^Fdf      , Gs^Fdf      , Gs^Fp       , Rd          , Gs^Fp       , Gs^Fp       , Gs^Fp       , Gs^Fmf      , Gs^Fmf      , Gs^Fmf      , Gs^Fmf      , Gs^Fmf      , Gs^Fmf      , Gs^Fdf      , Gg          , Gg          , Gg          , Gg          , Gg^Dr       , Gg          , Gg          , Gs^Fp       , Gs^Fp       , Gs^Fp       , Gs^Fp       , Gs^Fp       , Gg          , Gs^Fp       , Gg          , Gs^Fp       , Gg          , Gs^Fp       , Gg          , Gg          , Gg          , Gg          , Gg          , Gs^Fp       , Gs^Fp       , Gs^Fp       
Gs^Fp       , Gs^Fmf      , Gs^Fmf      , Gs^Fdf      , Gs^Fdf      , Rd          , Rd          , Gs^Fmf      , Gs^Fmf      , Gs^Fmf      , Gs^Fmf      , Gs^Fmf      , Gs^Fmf      , Gs^Fmf      , Gg          , Gg          , Gg          , Gg          , Gg          , Gg          , Gg          , Gg          , Gg          , Gs^Fp       , Gs^Fp       , Gg^Fet      , Gs^Fp       , Gs^Fp       , Gg          , Gg          , Gg^Dr       , Chr^Bzu     , Chr         , Gg^Dr       , Chr         , Chr         , Gg^Dr       , Gg          , Gg          , Gs^Fp       , Gs^Fp       , Gs^Fp       
Gs^Fmf      , Gs^Fp       , Gs^Fp       , Gs^Fmf      , Gs^Fp       , Gs^Fmf      , Gs^Fp       , Rd          , Rp          , Gs^Fmf      , Gg          , Gs^Fmf      , Gg          , Gg          , Gg          , Gg          , Rp^Dr       , Chr         , Chr         , Gg          , Gg          , Gg          , Rp^Dr       , Gg          , Gg          , Gs^Fp       , Gg          , Gg          , Gg          , Gg          , Gg          , Gg          , Gg          , Gg          , Chr^Bzu     , Gg          , Chr^Bzu     , Gg          , Gg          , Gs^Fp       , Gs^Fp       , Gs^Fdf      
Gs^Fmf      , Gs^Fmf      , Gs^Fmf      , Gs^Fmf      , Gs^Fmf      , Gs^Fp       , Gg          , Rp          , Rp          , Rp          , Rp          , Gg^Dr       , Gg          , Gg          , Chr^Bzu     , Chr         , Rp          , Rp          , Rp          , Chr         , Chr^Bzu     , Chr         , Rp          , Rp^Dr       , Chr         , Gg          , Gg          , Gg^Dr       , Chr         , Gg          , Gg^Ve       , Gg          , Rp          , Gg^Dr       , Chr         , Gg^Dr       , Gg          , Gg          , Gg          , Gs^Fp       , Gs^Fp       , Gs^Fp       
Gs^Fp       , Gs^Fmf      , Gs^Fmf      , Gg^Fet      , Gs^Fp       , Gs^Fmf      , Gg          , Gg          , Gg          , Rp          , Rp          , Rp          , Chr^Bzu     , Gg^Dr       , Chr         , Rp          , Rp          , Rp          , Rp          , Rp          , Rp          , Rp          , Rp          , Rp          , Rp^Dr       , Gg          , Gg          , Gg          , Gg          , Gg^Dr       , Gg          , Gg          , Rp          , Gg          , Chr         , Gg          , Gs^Fp       , Gs^Fdf      , Gs^Fdf      , Gs^Fp       , Gs^Fp       , Gs^Fdf      
Gs^Fp       , Gs^Fp       , Gs^Fp       , Gs^Fp       , Gs^Fp       , Gs^Fp       , Gg          , Gg^Dr       , Gg          , Gg          , Chr^Bzu     , Rp          , Rp          , Rp          , Rp          , Rp^Dr       , Chr         , Rp          , Rp^Dr       , Chr         , Rp          , Rp          , Rp          , Rp          , Chr         , Chr^Bzu     , Gg          , Gg          , Gg          , Gg          , Gg          , Gg          , Rp          , Gg^Dr       , Gg          , Gg          , Gs^Fdf      , Gs^Fmf      , Gs^Fmf      , Gs^Fp       , Gs^Fdf      , Gs^Fdf      
Gs^Fp       , Gs^Fp       , Gs^Fp       , Gs^Fp       , Gs^Fp       , Gs^Fp       , Gg          , Gg          , Gg          , Gg          , Gg          , Gg^Dr       , Chr         , Rp          , Chr         , Rp^Dr       , Rp          , Rp          , Chr         , Rp          , Rp          , Chr         , Rp^Dr       , Rp          , Rp          , Chr         , Chr         , Gg          , Gg          , Gg          , Gg          , Rp          , Rp          , Gg          , Gg          , Gg^Dr       , Gg          , Gs^Fdf      , Gs^Fp       , Gs^Fdf      , Gs^Fdf      , Gs^Fdf      
Gs^Fp       , Gs^Fmf      , Gs^Fmf      , Gs^Fp       , Gs^Fp       , Gs^Fp       , Gg^Dr       , Gg          , Gg          , Gg          , Gg          , Gg          , Chr^Bzu     , Rp^Dr       , Rp          , Rp          , Rp^Dr       , Chr^Bzu     , Rp          , Rp          , Chr         , Rp^Dr       , Rp^Dr       , Rp          , Rp          , Rp          , Chr         , Gg          , Gg          , Gg          , Rp          , Rp          , Gg^Dr       , Chr         , Gg^Dr       , Chr         , Gg          , Gg          , Gs^Fdf      , Gs^Fdf      , Gs^Fdf      , Gs^Fp       
Gs^Fp       , Gs^Fdf      , Gs^Fmf      , Gs^Fmf      , Gs^Fdf      , Gs^Fp       , Gg          , Gg          , Gg          , Gg          , Gg          , Gg          , Chr         , Rp          , Rp          , Chr         , Rp          , Rp          , Rp          , Rp          , Chr         , Rp^Dr       , Chr         , Rp^Dr       , Chr         , Rp          , Chr         , Gg          , Rp          , Rp          , Gg^Dr       , Chr         , Gg          , Gg          , Gg          , Gg          , Gg          , Gg          , Gs^Fp       , Gs^Fp       , Gs^Fp       , Gs^Fdf      
Gs^Fmf      , Gs^Fp       , Gs^Fmf      , Gs^Fmf      , Gs^Fmf      , Gs^Fp       , Gg          , Gg          , Gg          , Gg^Dr       , Gg          , Chr         , Rp^Dr       , Rp^Dr       , Rp          , Rp          , Rp          , Rp          , Rp          , Rp          , 1 Khr       , Rp          , Rp          , Rp          , Rp          , Rp          , Rp          , Chr         , Gg          , Gg          , Gg          , Gg          , Rp          , Gg          , Gg^Dr       , Gg          , Gg          , Gg^Ve       , Gs^Fdf      , Gs^Fp       , Gs^Fp       , Gs^Fdf      
Gs^Fmf      , Gs^Fmf      , Gs^Fmf      , Gs^Fmf      , Gs^Fmf      , Gs^Fp       , Gg          , Gg^Ve       , Gg          , Gg          , Gg          , Rp^Dr       , Rp          , Rp          , Chr         , Chr         , Rp          , Rp          , Chr         , Chr         , Rp          , Chr         , Chr         , Rp          , Rp          , Rp          , Rp          , Chr         , Gg          , Gg          , Gg          , Rp          , Rp          , Rp          , Gg          , Gg          , Gg          , Gs^Fdf      , Hh^Fp       , Hh^Fmf      , Hh^Fmf      , Gs^Fp       
Gs^Fp       , Gs^Fmf      , Gs^Fmf      , Gs^Fp       , Gs^Fp       , Gs^Fp       , Gg          , Gg          , Gg^Dr       , Gg          , Chr         , Chr         , Rp^Dr       , Rp          , Rp^Dr       , Rp          , Rp          , Rp^Dr       , Rp          , Rp          , Rp^Dr       , Rp^Dr       , Rp          , Rp^Dr       , Chr         , Rp          , Rp          , Chr^Bzu     , Gg^Dr       , Gg          , Gg          , Rp          , Rp          , Rp          , Gg          , Gg          , Gg          , Gs^Fdf      , Hh^Fdf      , Hh^Fmf      , Hh^Fmf      , Hh^Fmf      
Gs^Fdf      , Gs^Fdf      , Gs^Fdf      , Gs^Fmf      , Gs^Fp       , Gg          , Gg^Dr       , Gg          , Gg          , Gg          , Chr         , Rp^Dr       , Rp          , Rp          , Rp          , Rp^Dr       , Chr         , Chr         , Rp          , Chr         , Rp          , Rp          , Rp          , Rp          , Rp          , Khr         , Rp          , Rp          , Chr^Bzu     , Gg          , Gg          , Gg          , Gg          , Gg          , Gg          , Gg          , Gg          , Gs^Fp       , Gs^Fp       , Hh^Fdf      , Hh^Fdf      , Hh^Fmf      
Gs^Fmf      , Gs^Fdf      , Gs^Fmf      , Gs^Fdf      , Gg          , Gg          , Gg          , Gg          , Gg          , Gg          , Rp^Dr       , Rp          , Rp^Dr       , Rp          , Rp          , Rp          , Rp          , Rp          , Rp^Dr       , Rp^Dr       , Rp          , Rp          , Rp          , Rp          , Rp^Dr       , Chr         , Rp          , Rp          , Chr         , Gg          , Gg          , Gg          , Gg          , Gg^Ve       , Gg          , Gg          , Gg          , Gs^Fdf      , Gs^Fdf      , Gs^Fdf      , Ww          , Ww          
Gs^Fmf      , Gs^Fmf      , Gs^Fmf      , Gs^Fmf      , Gs^Fmf      , Gg^Dr       , Gg          , Gg          , Gg          , Gg          , Rp^Dr       , Rp          , Rp^Dr       , Rp          , Rp^Dr       , Rp          , Rp^Dr       , Chr         , Chr         , Rp          , Rp          , Rp          , Rp          , Rp          , Rp          , Rp          , Rp^Dr       , Rp^Dr       , Gg          , Gg          , Gg          , Gg          , Gg          , Gg          , Gg          , Gg          , Gg          , Gg          , Gs^Fdf      , Gs^Fp       , Ww          , Ww          
Gs^Fp       , Gs^Fmf      , Gs^Fmf      , Gs^Fmf      , Gs^Fp       , Gg          , Gg          , Gg^Ve       , Gg          , Gg          , Rp^Dr       , Rp          , Rp^Dr       , Rp          , Rp          , Rp          , Rp          , Rp          , Rp          , Chr         , Chr         , Rp          , Rp          , Rp^Dr       , Chr         , Chr         , Gg          , Gg          , Gg          , Gg          , Gg          , Gg          , Gg          , Gg          , Gg          , Gg          , Gg          , Gg          , Ww          , Ww          , Hh^Fmf      , Hh^Fdf      
Gs^Fmf      , Gs^Fmf      , Gs^Fmf      , Gs^Fmf      , Gs^Fmf      , Gg          , Gg          , Gg          , Gg          , Gg          , Chr         , Rp^Dr       , Rp          , Rp^Dr       , Rp^Dr       , Chr         , Chr         , Rp          , Rp          , Rp          , Rp          , Chr         , Chr^Bzu     , Chr         , Gg          , Gg          , Gg          , Gg          , Gg          , Gg          , Gg          , Gg          , Gg          , Gg          , Ww          , Ww          , Ww          , Ww          , Gs^Fp       , Hh^Fmf      , Hh^Fdf      , Hh^Fmf      
Gs^Fp       , Gs^Fmf      , Gs^Fmf      , Gs^Fmf      , Gg          , Gg          , Gg          , Gg          , Gg          , Gg          , Gg          , Chr         , Chr^Bzu     , Rp          , Rp          , Rp          , Chr         , Rp          , Rp^Dr       , Rp          , Rp          , Rp          , Rp          , Gg          , Gg          , Gg^Dr       , Gg          , Gg          , Gg          , Gg          , Gg          , Gg^Dr       , Ww          , Ww          , Gg          , Ww          , Gg          , Gs^Fp       , Gs^Fp       , Gs^Fmf      , Gs^Fmf      , Hh^Fdf      
Gs^Fp       , Gs^Fp       , Gs^Fmf      , Gs^Fdf      , Gs^Fp       , Gg          , Gg          , Gg          , Gg          , Gg          , Gg          , Gg          , Gg          , Chr         , Chr         , Rp          , Rp          , Rp^Dr       , Chr         , Rp          , Rp          , Rp          , Rp          , Gg          , Gg          , Gg          , Gg          , Gg          , Gg          , Gg          , Ww          , Ww          , Ww          , Gg          , Gg          , Gg^Ve       , Gg          , Gs^Fp       , Gs^Fmf      , Gs^Fp       , Gs^Fdf      , Gs^Fmf      
Gs^Fmf      , Gs^Fmf      , Gs^Fmf      , Gs^Fmf      , Gs^Fmf      , Gs^Fp       , Gg          , Gg          , Chr^Bzu     , Chr         , Chr         , Gg          , Gg          , Gg          , Gg          , Chr         , Gg^Dr       , Rp          , Chr         , Rp          , Rp          , Rp          , Rp          , Chr^Bzu     , Gg          , Gg          , Gg          , Gg          , Ww          , Ww          , Ww          , Ww          , Gg          , Gg          , Gg          , Gg          , Gs^Fp       , Gs^Fdf      , Gs^Fdf      , Gs^Fmf      , Gs^Fmf      , Gs^Fdf      
Gs^Fp       , Gs^Fmf      , Gs^Fmf      , Gs^Fmf      , Gs^Fp       , Gs^Fp       , Gg          , Gg^Dr       , Gg          , Gg          , Chr^Bzu     , Gg^Dr       , Gg          , Gg          , Gg          , Gg          , Gg          , Gg^Dr       , Gg          , Chr         , Rp^Dr       , Rp          , Rp          , Rp          , Rp          , Gg          , Chr^Bzu     , Ww          , Ww          , Ww          , Gg          , Gg          , Gg          , Gg          , Gg          , Gg          , Gs^Fp       , Gs^Fmf      , Gs^Fmf      , Gs^Fdf      , Gs^Fp       , Gs^Fp       
Gs^Fmf      , Gs^Fp       , Gs^Fmf      , Gs^Fmf      , Gs^Fmf      , Gs^Fp       , Gs^Fp       , Chr         , Chr         , Chr         , Gg          , Chr         , Chr         , Gg          , Gg          , Gg          , Gg          , Gg          , Gg          , Gg^Dr       , Gg          , Chr^Bzu     , Gg          , Rp          , Rp          , Rp          , Wwf         , Ww          , Chr^Bzu     , Gg          , Gg          , Gg^Ve       , Gg          , Gg          , Gg          , Gg          , Xu          , Gs^Fp       , Gs^Fp       , Gs^Fmf      , Re          , Gs^Fp       
Gs^Fmf      , Gs^Fmf      , Gs^Fp       , Gs^Fmf      , Gs^Fmf      , Gs^Fmf      , Gs^Fp       , Gg          , Gg          , Gg          , Gg          , Gg          , Chr^Bzu     , Gg^Dr       , Gg          , Gg          , Gg          , Gg          , Gg          , Gg          , Gg          , Gg          , Gg          , Gg          , Chr^Bzu     , Rp          , Wwf         , Wwf         , Rp          , Gg          , Gg          , Gg          , Gg          , Gg          , Gg          , Xu          , Xu          , Xu          , Re          , Re          , Re          , Re          
Gs^Fp       , Gs^Fmf      , Gs^Fmf      , Gs^Fdf      , Gs^Fdf      , Gs^Fdf      , Gs^Fdf      , Gs^Fdf      , Gs^Fdf      , Gs^Fmf      , Gs^Fmf      , Gg          , Gg          , Gg          , Gg          , Gg          , Gg^Ve       , Gg          , Gg          , Gg          , Gg          , Gg          , Gg          , Gg          , Ww          , Wwf         , Wwf         , Rp          , Rp          , Rp          , Rp          , Gg          , Gg          , Gg          , Gg          , Xu          , Xu          , Xu          , Gs^Fp       , Re          , Gs^Fp       , Gs^Fp       
Hh^Fmf      , Hh^Fmf      , Hh^Fmf      , Gs^Fp       , Gs^Fp       , Gs^Fdf      , Gs^Fp       , Gs^Fdf      , Gs^Fp       , Gs^Fdf      , Ww          , Gs^Fmf      , Ww          , Gg          , Ww          , Gg          , Ww          , Gg          , Ww          , Ww          , Ww          , Gg          , Ww          , Gg          , Ww          , Ww          , Gg          , Chr^Bzu     , Gg          , Rp          , Rp          , Rp          , Rp          , Gg          , Gg          , Gg          , Gs^Fp       , Gs^Fp       , Gs^Fdf      , Gs^Fmf      , Gs^Fmf      , Gs^Fp       
Hh^Fmf      , Hh^Fmf      , Hh^Fdf      , Hh^Fmf      , Hh^Fmf      , Gs^Fp       , Gs^Fp       , Gs^Fp       , Ww          , Ww          , Ww          , Ww          , Ww          , Wwf         , Ww          , Ww          , Ww          , Ww          , Ww          , Ww          , Ww          , Wwf         , Ww          , Ww          , Gg          , Gg          , Gg          , Gg          , Gg          , Gg          , Gg          , Rp          , Rp          , Rp          , Gg          , Gg          , Gs^Fdf      , Gs^Fp       , Gs^Fp       , Gs^Fdf      , Gs^Fdf      , Gs^Fmf      
Hh^Fdf      , Hh^Fmf      , Hh^Fmf      , Hh^Fmf      , Gs^Fp       , Gs^Fp       , Ww          , Ww          , Ww          , Ww          , Ww          , Ww          , Gs^Fp       , Gg          , Gg          , Gg          , Gg          , Gg          , Gg          , Ggf         , Ggf         , Gg          , Gg          , Ww          , Ww          , Gg          , Ww          , Gg^Dr       , Gg          , Gg          , Gg          , Gg          , Gg          , Rp          , Rp          , Gg          , Gg^Ve       , Gs^Fdf      , Gs^Fdf      , Gs^Fdf      , Gs^Fdf      , Gs^Fp       
Ww          , Hh^Fdf      , Ww          , Hh^Fdf      , Ww          , Ww          , Ww          , Ww          , Gs^Fp       , Gs^Fp       , Gs^Fp       , Gs^Fp       , Rp          , Gg          , Gg          , Gg          , Gg          , Gg^Dr       , Gg          , Gg          , Ggf         , Ggf         , Ggf         , Gg          , Ggf         , Ww          , Gg          , Ww          , Gg          , Gg          , Gg          , Gg          , Gg^Srat     , Rp          , Rp          , Gg          , Gg          , Gs^Fdf      , Gs^Fmf      , Gs^Fmf      , Gs^Fmf      , Gs^Fdf      
Ww          , Ww          , Ww          , Ww          , Ww          , Ww          , Gs^Fp       , Gs^Fp       , Gs^Fp       , Gs^Fp       , Gg          , Rp          , Rp          , Rp          , Gg          , Gg          , Gg          , Gg          , Gg          , Gg          , Gg          , Ggf         , Ggf         , Ggf         , Ggf         , Ggf         , Ggf         , Ww          , Ww          , Gg          , Gg          , Gg^Srjt     , 2 Gg^Sct    , Gg^Srot     , Gg          , Rp          , Rp          , Gs^Fmf      , Gs^Fmf      , Gs^Fmf      , Gs^Fmf      , Gs^Fp       
Hh^Fdf      , Ww          , Hh^Fmf      , Hh^Fmf      , Hh^Fmf      , Gs^Fp       , Gs^Fp       , Gs^Fp       , Gg          , Gg          , Chr         , Rp          , Rp          , Rp          , Rp          , Gg          , Rp          , Gg          , Gg          , Gg^Ve       , Gg          , Gg          , Ggf         , Ggf         , Ggf         , Gg          , Gg          , Gg^Ve       , Ww          , Ww          , Gg          , Gg^Srjl     , Gg^Srgt     , Gg^Srst     , Gg          , Rp          , Rp          , Gs^Fp       , Gs^Fp       , Gs^Fmf      , Gs^Fmf      , Gs^Fdf      
Hh^Fdf      , Hh^Fmf      , Hh^Fdf      , Hh^Fmf      , Hh^Fdf      , Hh^Fmf      , Gs^Fp       , Gg          , Gg          , Gg^Dr       , Chr^Bzu     , Gg^Dr       , Chr         , Gg          , Gg          , Rp          , Ggf         , Rp          , Rp          , Gg          , Ggf         , Ggf         , Rp          , Ggf         , Rp          , Gg          , Gg          , Ww          , Ww          , Ww          , Gg          , Gg          , Gg          , Gg          , Gg          , Rp          , Rp          , Gg          , Gg          , Gg          , Gg          , Gs^Fdf      
Hh^Fdf      , Hh^Fmf      , Hh^Fmf      , Hh^Fdf      , Hh^Fdf      , Hh^Fmf      , Gs^Fp       , Gs^Fp       , Gs^Fp       , Gs^Fp       , Gs^Fp       , Chr         , Gg          , Gg^Dr       , Gg          , Gg          , Ggf         , Ggf         , Ggf         , Rp          , Rp          , Rp          , Rp          , Rp          , Ggf         , Rp          , Gg          , Ww          , Ww          , Gg          , Gg          , Gg          , Gg          , Gg          , Gg          , Gg          , Rp          , Gg          , Gg          , Gg          , Gs^Fmf      , Gs^Fmf      
Gs^Fp       , Gs^Fp       , Gs^Fp       , Hh^Fmf      , Gs^Fp       , Gs^Fp       , Gs^Fp       , Gs^Fp       , Gs^Fp       , Gg^Fet      , Gs^Fp       , Gs^Fp       , Gg          , Gg          , Gs^Fp       , Gg          , Gg          , Ggf         , Rp          , Rp          , Gg          , Rp          , Rp          , Rp          , Ggf         , Rp          , Rp          , Gg          , Gg          , Ww          , Ww          , Gg          , Gg          , Gg          , Gg          , Rp          , Rp          , Gg          , Gg          , Gg          , Gs^Fmf      , Gs^Fmf      
Gs^Fp       , Gs^Fp       , Gs^Fp       , Gs^Fp       , Gs^Fp       , Gs^Fp       , Gs^Fp       , Gs^Fdf      , Gs^Fdf      , Gs^Fp       , Gs^Fp       , Gs^Fdf      , Gs^Fmf      , Gs^Fmf      , Gs^Fmf      , Gs^Fp       , Gs^Fp       , Rp          , Gg          , Gg          , Gg^Ve       , Ggf         , Ggf         , Ggf         , Ggf         , Ggf         , Ggf         , Rp          , Rp          , Rp          , Wwf         , Rp          , Rp          , Rp          , Rp          , Gg          , Rp          , Gg          , Gg          , Gg          , Gs^Fmf      , Gs^Fmf      
Gs^Fp       , Gs^Fp       , Gs^Fp       , Gs^Fp       , Gg^Fet      , Gs^Fp       , Gs^Fp       , Gs^Fp       , Gs^Fp       , Gs^Fdf      , Gs^Fdf      , Gs^Fmf      , Gs^Fmf      , Gs^Fmf      , Gs^Fdf      , Gs^Fmf      , Gs^Fp       , Gg          , Gg^Dr       , Gg          , Ggf         , Gg          , Ggf         , Ggf         , Ggf         , Ggf         , Gg          , Gg          , Gg^Ve       , Gg          , Ww          , Gg          , Gg          , Gg          , Gg          , Rp          , Rp          , Rp          , Rp          , Chr^Bzu     , Gs^Fmf      , Gs^Fmf      
Gs^Fp       , Gs^Fp       , Gs^Fp       , Gs^Fp       , Gs^Fp       , Gs^Fmf      , Gs^Fmf      , Gs^Fp       , Gs^Fmf      , Gs^Fmf      , Gs^Fmf      , Gs^Fmf      , Gs^Fmf      , Gs^Fmf      , Gs^Fmf      , Gs^Fdf      , Gs^Fdf      , Gs^Fp       , Gg          , Gg          , Gg          , Ggf         , Ggf         , Ggf         , Ggf         , Ggf         , Gg          , Gg          , Gs^Fp       , Gg          , Ww          , Gg          , Gs^Fp       , Gg          , Gs^Fp       , Gg          , Gs^Fp       , Rp          , Rd          , Rd          , Gs^Fp       , Gs^Fmf      
Gs^Fp       , Gs^Fp       , Gs^Fp       , Gs^Fp       , Gs^Fdf      , Gs^Fmf      , Gs^Fmf      , Gs^Fmf      , Gs^Fmf      , Gs^Fmf      , Gs^Fmf      , Gs^Fmf      , Gs^Fp       , Gs^Fmf      , Gs^Fp       , Gs^Fmf      , Gs^Fmf      , Gs^Fp       , Gs^Fp       , Gs^Fp       , Gs^Fp       , Gs^Fp       , Gs^Fp       , Gs^Fp       , Gs^Fp       , Gs^Fp       , Gs^Fp       , Gs^Fmf      , Ww          , Ww          , Gs^Fmf      , Gs^Fp       , Gs^Fp       , Gs^Fp       , Gs^Fdf      , Gs^Fmf      , Gs^Fdf      , Chr^Bzu     , Gs^Fp       , Rd          , Rd          , Gs^Fp       
Gs^Fp       , Gs^Fp       , Gs^Fp       , Gs^Fp       , Gs^Fp       , Gs^Fdf      , Gs^Fdf      , Gs^Fmf      , Gs^Fp       , Gs^Fmf      , Gs^Fmf      , Gs^Fmf      , Gs^Fp       , Gs^Fp       , Gs^Fp       , Gs^Fp       , Gs^Fp       , Gs^Fp       , Gs^Fp       , Gs^Fp       , Gs^Fp       , Gs^Fp       , Gs^Fp       , Gs^Fp       , Gs^Fp       , Gs^Fp       , Gs^Fp       , Gs^Fp       , Ww          , Gs^Fdf      , Gs^Fdf      , Gs^Fmf      , Gs^Fmf      , Gs^Fp       , Gs^Fp       , Gs^Fdf      , Gs^Fdf      , Gs^Fdf      , Gs^Fdf      , Rd          , Rd          , Gs^Fp       
